XXXXXXXXXXXXXXXXXXXXX
PO    X X X     X   X
XOXXX X X X X X XXX X
XO  X   X   X X   X X
XOX XXXXXXXXX XXX X X
XOX           X X X X
XOXXXXXXXXXXXXX X X X
XOXOOO  XOOOOOOOX   X
XOXOXOXXXOXXXXXOXXX X
XOOOXOOOOO    XOOOOOK
XXXXXXXXXXXXXXXXXXXXX

