XXXXXXXXXXXXXXXXXXXXX
X     X X X     X   X
X XXX X X X X X XXX X
X   X   P   X X   X X
X X XXXXXXXXX XXX X X
X X           X X X X
X XXXXXXXXXXXXX X X X
X X     X       X   X
X X X XXX XXXXX XXX X
X   X         K     X
XXXXXXXXXXXXXXXXXXXXX
