XXXXXXXXXXXXXXXXXXXXX
X   X         X     X
X XXX XXXXXXX X XXXXX
X X   X     X X X   X
X X XXX XXX X X X X X
X X   X X   X X   X X
X XXX X X XXX XXXXX X
X X   X X X   X   X X
X X XXX X X XXX X X X
X   X   X X X   X X X
XXXXX X X X X XXX X X
X     X X X   X   X X
X XXXXX XXXXXXX XXX X
X     X       X X   X
XXXXX XXX XXX X XXX X
X     X   X   X X   X
X XXXXX XXXXXXX X XXX
X X     X   X   X   X
X X XXXXX X X XXXXX X
X X       X         X
XXXXXXXXXXXXXXXXXXXXX
