XXXXXXXXXXXXXXXXXXXXX
P     X   X   X   X X
X XXXXX X X X X X X X
X   X   X   X   X X X
XXX XXX XXXXXXXXX X X
X X   X   X     X X X
X XXX XXX X XXXXX X X
X   X     X   X   X X
X XXXXXXXXX X X XXX X
X       X   X   X   X
X XXXXX X XXXXXXX X X
X     X   X   X   X X
XXXXX XXXXX X XXX X X
X     X     X   X X X
X XXXXXXX XXXXX X X X
X         X   X X X X
XXXXXXXXXXX X X XXX X
X         X X   X   X
X XXXXX XXX XXXXX X X
X     X           X K
XXXXXXXXXXXXXXXXXXXXX